1111111111111
1000000P00001
1E000000000E1
100000C000001
1111111111111
