1111111111111111111111
1P10000000000010C00001
1010000000000010000001
1000000000000010000001
110000000C000000001101
1E1000000000000001C001
1111111111111111111111
