111111111
100000001
1P0000001
100000001
111110C01
100010001
1000100E1
111111111
111111111