111111111111111111111111111111
100000000000000000000000000001
1P0000000000000000000000000001
10000000000000000000C000000001
111110C00000000000000000000001
100010010000000000000000000001
1000101E00000000000CCC00000001
111111110000000000000000000001
111111110000000000000000000001
11111111000000C000000000000001
111111110000000000000000000001
111111110000000000000000000001
1111111100000000000000000C0001
111111110000000000000000000001
111111110000C000000C0000000001
111111110000000000000000000001
1111111100000000C0000000000001
111111110000000000000000000001
111111110000000000000000000001
111111111111111111111111111111
