1111111111
1000P0P001
1000000001
1C0000E001
1111111111
