111111111111111111111111111
10000001C000000000000000001
1000P0001111111000000000001
111000000010000000000000001
1CC100000010010000000000001
100100000000100000000000001
100100000010000000000000001
100000001111111111000000001
10000001E000000000000000001
111111111111111111111111111
